NO ./LICENSE 
SO ./LICENSE
WE ./LICENSE
EA ./LICENSE

F 255 , 100 , 0
C 225 , 255, 255

    11111111111111111
    10000000000000001
    1000000N000000001
    10000000000000001
    11111111111111111
