NO ./texture/Test/brick.xpm
SO ./texture/Test/metal.xpm



























                                                       
													   
													   
													   
													   
													   
													   
													   
													   
EA ./texture/Test/wood.xpm
																											   
WE ./texture/Test/pebbles.xpm
F 255,100,0
C 225,255,255

    11111111111111111111111111111
    10000000000100000000000000001
    10000000000000000000000000001
    10000000000000E00000111110001
     1111110000000000001     1001
          10000100000011111110011
          1000000000000000000001
          100000000000000000001
          10000000000000000011
          100000000000000001
          10000001110000001
          10000001 1000001
          1000000111000001
          100000000000001
          10000000000001
          1000000000001
          100000000001
111111111110000000001
10000000000000000001
10000000000000000001
10000000000000000001
10000000000000000001
10000000000000000001
11111111111111111111
 
 
 
111111111
100000001
100000001
100000001
100000001
111111111
